5 5
2 3 . . .
2 . X X .
X 3 . 7 X
. 1 . . .
3 3 2 . 6